NO ./textures/eagle.xpm
SO ./textures/bluestone.xpm
WE    ./textures/mossy.xpm
EA ./textures/redbrick.xpm









F    123,53, 180
C 53,164,174

        1111111111111111111111111
        1000000000110000000000001
        1011000001110000000000001
        1001000000000000000000001
111111111011000001110000000000001
1000000000110000011111111O1111111
11110111111111011100000010001
11110111111111000001010000001
11000000110101000000000000001
10000000000000001100000010101
10000000000000001101010010001
11000001110101011111011110N0111
11110111 1110101 101111010001
11111111 1111111 111111111111
