NO ./textures/eagle.xpm
SO ./textures/bluestone.xpm
WE    ./textures/mossy.xpm
EA ./textures/redbrick.xpm
EA ./textures/redbrick.xpm
EA ./textures/redbrick.xpm
EA ./textures/redbrick.xpm
EA ./textures/redbrick.xpm
EA ./textures/redbrick.xpm
EA ./textures/redbrick.xpm
EA ./textures/redbrick.xpm
EA ./textures/redbrick.xpm
EA ./textures/redbrick.xpm
EA ./textures/redbrick.xpm
EA ./textures/redbrick.xpm
EA ./textures/redbrick.xpm
EA ./textures/redbrick.xpm
EA ./textures/redbrick.xpm



F 146,116,91
C 135,206,235


1111111111111111111111111111
1000000000000000000000000001
1000000000000000000000000001
1000000000000000000000000001
1000000000000000011111000001
1000000011000000111111110001
1000000111000000100000110001
1000001111000000100000110001
1000001110000000100000110001
1000011100000000000001110001
1000111000000000000111000001
1001110000000000001110000001
1001100000000000011100000001
1011100000000000111000000001
1011111111110000111111111001
1011111111110000111111111001
1000000001100000000000000001
1000000001100000000000000001
1000000000000000000000000001
10000000000000000N0000000001
1000000000000000000000000001
1000000000000000000000000001
1111111111111111111111111111
