1111111111111111111
10000000000000000E1
1000000000000000001
1000000000000000001
1000000000X00000001
1000000000000000001
10000000000000C0001
100000P000000000001
1000000000000000001
1111111111111111111
