1111111111111111111
10000000000000000E1
1000000000000000001
1000000000000000001
1000000000000000001
1000000000000000001
10000000000C0000001
1000P00000000000001
1000000000000000001
1111111111111111111
