1111111111111111111
10000000000000000E1
1000000000000000001
1000000000000000001
100000000X000000001
1000000000000000001
1000000000000C00001
1000P00000000000001
1000000000000000001
1111111111111111111
